####################
#E#              #S#
# #              # #
# #              # #
# #              # #
# #              # #
# #              # #
# #       ###    # #
# ######### ###### #
#                  # 
####################