#############
# #  #E#    #
# #  # #    #
# #### #    #
# #  # #    #
# #  # #    #
# #### #    #
#           #
# ###########
#          S#
#############