###########
#E#   # # #
# ### # # #
#  #  #   #
#S### ### #
# #     # #
# # ##### #
# #       #
# ####### #
#         #
###########